░░░░░░░░░░░░░░░░░░░░░░░#░░░░#░░░░░░░░░░░░░░░░░░░░#░░░░#░░##░##░░░░░░░░░░░░░░░░░░░░░░░░░░░░░░░░░░░░░░░░░#░░░░░░░░░░░#░░░░░░░░░░░#░░
░░░░░░░░░░░░░#░░░░░░░░░░░░░░░░░░░░░░░░░░░░░░░░░░░░░░░░#░░▓▓▓▓▓▓▓▓▓▓▓▓▓▓▓▓▓▓#░░░░░░░░░░░░#░░░░░░░░░░░░░░░░░░░░░░░#░░░░░░░░░░░░#░░░░
░░░░░░░░░#░░░░░░░░░░░░░#░░#░░░░#░░░░░░░░░░░░░░░░░░░░░░░░░▓#░░░░░░░#░#░░░░░▓░#░░░░░░░░░░░░░░░░░░░░░░░░░░░░░░░░░░░░░░░░░░░░░░░##░░░░
░░░░░░░░░░#░░░░#░░░░░░░▓▓▓▓▓▓▓▓▓▓▓▓▓▓▓▓▓▓▓▓▓▓▓▓▓▓▓▓▓▓▓▓▓▓▓▓▓▓▓▓▓▓▓▓▓#░░░░░▓░░░░░░░░░░░░░░#░░░░░░░░░░░#░░░░#░░░░░░░░░░░░░░░░░░░░░░░
░░░░░░░░░░░░░#░░░#░░░░░▓░░░░░░░░░░░░░░#░░░░░░░░░░░#░░░░░░▓░░#░░░░░░▓░░░░░░▓░░░░░░░░░░░░░#░░░░░░░░░░░░#░░░░░░░░░░░░░░░░░░░░░░░░░░░░
░░░░░░░░░░░░░░░░░░░░░░░▓░░░░░░░░░░░░░░░░░░░░░░░░░░░░░░░░░▓░░░░░░░░░▓░░░░░░▓░░░░░░░░░░░░░░░#░░░░░#░░░░░░░#░░░░░░░░░░░░░░░░░░░##░░░░
░░░░░░░░░░░░░░░░░░░░░░░▓░░░░░░░░░░░░░░░░░░░░░░░#░#░░░░░░#▓▓▓▓▓▓▓▓▓▓▓░░░#░░▓#░░░░░░░░░░░░░░░░░░░##░░░░░░░░░░░#░░░░#░░#░░░#░░░░░░░░░
░░#░░░░░░░░░░░░░░░░░#░░▓░░░#░░░░░░░░#░░░░░░░░░░▓▓▓▓▓▓▓▓▓▓▓▓#░░░░░░░#░░░░░░▓░░░░░░░░░░░░░░░░░░░░░░░░#░░░░░░░░░░░░░░░░░░░░░░░░░░░░░░
░░░░░░░░░░░░░░░░░░░░░░░▓░#░░░░░░░░░░░░░░░#░░░░░▓░░░░░░░░░░▓░░░░░░░░░░░░░░░▓░░░░#░░░░#░░#░░#░░░░░░░░░░░░░░░░░░░░░░░░░░░░#░░░░░░░░░░
░░░░░░░░░░░░░░░░░░░░░░#▓░▓▓▓▓▓▓▓▓▓▓▓▓▓▓▓▓▓▓▓▓▓▓▓▓▓▓▓▓▓▓▓▓▓▓▓▓▓▓▓▓▓▓▓▓▓▓▓▓▓▓▓▓▓▓▓▓▓▓▓▓▓▓▓#░░░░░░░░░░#░░░░░░░░░░░░░░#░░░#░░░░░░#░░░░
░░░░░░░░░░░░░░░░░░░░░░░▓░▓░░#░░░░░##░░░░░░░░░░#▓░░░░░░░░░░▓░░░░░░░░░#░░░░░▓░░░░#░░#░░░░▓░░#░░░░░░░░░░░░░░░░░░░░░░░░░░░░░░░░░░░░░░░
░░░░░░#░░░###░░░░░░░░░░▓#▓░░░░░░░░░░░░░░░░░░░░░▓░░░░░░░░░░▓░░░░░░░░░▓▓▓▓▓▓▓▓▓▓▓▓▓▓▓▓▓▓▓▓▓▓#░░░░░░░░░░░░░░░░░░░░░░░░░░░░░░░░░░░░░░░
░░░░░░░░░░░░░░░░░░░░░░#▓#▓░#░░░░░░░░░░░░░░░░#░░▓░░░░░░░#░░▓░░░░░░░░░▓░░░#░▓░░░░░░░░░#░░▓░▓░░░░░░░#░░░░░░░░░░░░░░#░░░#░░░░░░░░░#░░░
░░░░#░░░░░░░░░░░░░░░░░░▓░▓░░░░#░░#░░░░░░░░░░░░░▓░░░░░░░▓▓▓▓▓▓▓▓▓▓▓▓▓▓▓▓▓▓▓▓▓▓▓▓▓▓#░░░░#▓░▓░░░░░░░░░░#░░░░░░░░░░░░░░░░░░░░░░░░░░░░░
░░#░░░░░░░░░░░░#░░░#░░░▓░▓░░░░░░#░░░░░░░░░░#░░░▓░░░░░░░▓░░▓#░░░░░#░░▓░##░░▓░░░░░▓░░░░░░▓░▓░░░░░░░#░░░░░░░░#░░░░░░░░░░░░░░░░░░░░░░░
░░░░░░░░░░░░░░░░░░#░░░░▓░▓░░░░░#░░░░░░░░░░░░░░#▓░░░░░░░▓░░▓░░░░░░░░░▓░▓▓▓▓▓▓▓▓▓▓▓▓▓▓▓▓▓▓▓▓▓▓▓▓▓▓▓▓▓▓▓▓▓▓▓#░░#░░#░░░░░░░░#░░░░░░░░░
░░░░░░░#░░░#░░░░░░░░░░░▓#▓▓▓▓▓▓▓▓▓▓▓▓▓▓▓▓▓▓▓▓▓▓▓▓▓▓▓▓▓▓▓▓▓▓▓▓▓▓▓▓▓▓▓▓▓▓▓▓▓▓▓▓▓▓▓▓░░#░░░▓░▓░░░░░░░░░░░░░░▓░░░░░░░░░#░░░░░░░░░░░░░#░
░░#░░░░▓▓▓▓▓▓▓▓▓▓▓▓#░░░▓░░░░░░░░░░░░░░░░#░#░░░#▓▓▓▓▓▓▓▓▓▓▓▓▓▓▓▓▓▓▓▓▓▓▓▓▓▓▓▓░░░░░#░░░░░░▓░▓#░░░░░░░░░░░░░▓░░░░░░#░░░░░░░░░#░░░░░░░░
░░░░░░░▓░░░░░░░░░░▓░░░░▓░░░░░░░░░░░#░░#░▓▓▓▓▓▓▓▓▓▓▓▓▓▓▓▓▓▓▓▓▓▓▓▓▓#░░▓░▓░░░#░░░░░#░░░░░░▓░▓▓▓▓▓▓▓▓▓▓▓▓▓▓▓▓▓▓▓▓▓▓▓▓▓▓▓▓▓▓▓▓▓#░░░░░░░
░░░░░░░▓░░░##░░░░░▓░░░░▓░░░░░░##░░░░░░░░▓░░░#░░░░░░░░░░▓░░▓░░#░░▓#░░▓░▓░░░░░░░░░▓▓▓▓▓▓▓▓▓▓▓▓▓▓▓▓▓▓▓▓##░░▓#░░░░░░░░░░░░░░░▓░░░░░░░░
░░░░░░░▓░░░░░░#░░░▓░░░░▓░░░░░░░░░#░░░░░░▓░░░▓▓▓▓▓▓▓▓▓▓▓▓▓▓▓▓▓▓▓▓▓▓▓▓▓▓▓▓▓▓▓▓▓▓▓▓▓▓▓▓▓▓▓▓▓▓▓▓▓▓▓▓▓▓▓▓▓▓#░▓░░░░░░░░░░░░░░░░▓░░░░░░░░
░#░░░#░▓░░#░░░░░░░▓░░##▓░░░░░░░░░░░░░░░░▓░░░▓░░░░░░░░░░▓░#▓░░░░░▓░░░▓░▓░░░░░░░░░▓░░░░░░▓░▓▓░░░░░░░░▓░▓░░▓░░░░░░░░░░░░░░#░▓░░░░#░░░
░░░░░░#▓░░░░#░░░░░▓░░░░▓░░░░░░░░░░░░░░░░▓░░░▓#░░░░░░░░░▓░▓▓▓▓▓▓▓▓▓▓▓▓▓▓▓▓▓▓▓▓▓▓▓▓▓▓▓▓▓▓▓▓▓▓▓▓▓▓▓▓▓▓▓▓▓▓▓▓▓▓▓▓#░░░░░░#░░░░▓░░░░░░░░
░░░░░░░▓░░#░░░░░░░▓░░░░▓░░░░░░░░░░░░░░░░▓░░░▓░░░░░░░░░░▓#▓▓░░░░░▓░░░▓░▓░░░░░░░░░▓░░░░##▓░▓▓#░░░░░░░▓░▓░░▓░░░▓░░░░░░░░#░░░▓░░░░░░░░
░░░░░░░▓░░#░░░░░░#▓░░░░▓░░░░░░░░░░░#░░░#▓░░░▓░░░#░░░░░░▓░▓▓░#░#░▓░░░▓░▓░░#░░░░░░▓░#░░░▓▓▓▓▓▓▓▓▓▓▓▓▓▓▓▓▓▓▓▓▓▓▓▓▓▓▓▓▓▓▓▓▓#░▓░░░░░░░░
░#░░░░░▓░░░░░░░░░░▓░#░#▓░░░░░░░░░░░░░░░░▓░░░▓░░░░░░#░░░▓░▓▓░░░░░▓░░░▓░▓░░░░#░░░░▓░░░░#▓▓░▓▓░░#░░░░░▓░▓░░▓░░░▓░░░░░░░░░▓░░▓░░░░░░░░
░░░░░░░▓░░░░░░░░░░▓░░#░▓░░#░░░░░░░░░░░░░▓░░░▓#░░░░░▓▓▓▓▓▓▓▓▓▓▓▓▓▓▓▓▓▓▓▓▓▓▓▓▓▓▓▓▓▓▓▓▓▓▓▓▓▓▓▓▓▓▓▓▓##░▓#▓░░▓░░░▓░░░░░░░░#▓░░▓░░░░░░░░
░░░░░░#▓░░░░░░░░░░▓░░░░▓░░░░░#░░#░░░░░░░▓░░░▓░░##░░▓░░░▓#▓▓▓▓▓▓▓▓▓▓▓▓▓▓▓▓▓▓▓▓▓▓▓▓▓▓▓▓▓▓▓░▓▓░░░░▓░░░▓░▓░░▓░░#▓░░░░░░░░░▓░░▓#░░░░░░░
░░░░░░░▓░░░░░░░░░░▓░░░░▓░░░░░▓▓▓▓▓▓▓▓▓▓▓▓▓▓▓▓▓▓▓▓▓▓▓▓▓▓▓▓▓▓▓▓▓▓▓▓▓▓▓▓▓▓▓▓▓#░░░░░▓░░#░░▓#░▓▓░░░░▓░░░▓░▓#░▓░░░▓░░░░░░░░░▓░#▓░░░░░░░░
░░░░░░░▓░░░░░░░░░░▓░##░▓░░#░░▓░░░░░░░░░░▓░░░▓░░░░░#▓░░░▓░░▓#░░░░▓░░░▓░▓░░▓░░░░░#▓░░░░░▓░░▓▓░░##▓░░░▓░▓#░▓░░░▓░░░░░░░░░▓░░▓░░░░░░░░
░░░░░░░▓░#░░░░░░░░▓░░░#▓▓▓▓▓▓▓▓▓▓▓▓▓▓▓▓▓▓▓▓▓▓▓▓▓▓▓▓▓▓▓▓▓▓▓▓▓▓▓▓▓▓▓▓▓▓▓▓▓▓▓▓▓▓▓▓▓▓▓▓▓▓▓▓▓▓▓▓░░░░▓░░░▓░▓░░▓#░░▓░░░░░░░░░▓░░▓░░░░░░░░
░░░░░░░▓░▓▓▓▓▓▓▓▓▓▓▓▓▓▓▓▓▓▓▓▓▓▓▓▓▓▓▓▓▓▓▓▓▓▓▓▓▓▓▓▓▓▓▓▓▓▓▓▓▓▓▓▓▓▓▓▓▓▓▓▓▓▓▓#▓░░░░░░▓░░░░░▓░░#▓░░░░▓░░░▓░▓░░▓░░░▓░░░░░#░░░▓░░▓░░░░░░#░
░░░░░░░▓░▓░░#░░░░░▓░#░░░░░░░░▓░░░░░░░░░░▓░░░▓░░░░░░▓░░#▓░░▓░░░░░▓░░#▓▓▓▓▓▓▓▓▓▓▓▓▓▓▓▓▓▓▓▓▓▓▓▓▓▓▓▓▓▓▓▓▓▓▓▓▓▓▓▓▓▓▓▓▓▓▓▓▓▓▓░░▓░░░░░░░░
░#░░░░░▓░▓░░▓▓▓#░░▓░░░░░░░░░░▓░░░░░░░░░░▓░░░▓░░░░░░▓░░░▓░░▓░░░░#▓░░░#░▓▓░▓░░░░#░▓░░#░░▓░░░▓░░░░▓░░░▓░▓░░▓░░░▓░░░░░░░░░#░#▓░░░░░░░░
░░░░░░░▓░▓░░▓░▓▓▓▓▓▓▓▓▓▓▓▓▓▓▓▓▓▓▓▓▓▓▓▓▓#▓░░░▓░░░░░░▓░░░▓░░▓░░░░▓▓▓▓▓▓▓▓▓▓▓▓▓▓▓▓▓▓▓▓▓▓▓▓▓▓▓▓▓▓▓▓▓▓▓▓▓▓▓▓▓▓▓▓▓▓▓▓▓▓▓▓▓▓▓▓▓▓▓▓▓▓#░░░░
░░░░░░░▓#▓░░▓░▓▓░░▓░░░░░░░░░░▓░░░░░░░░▓░▓░░░▓░░░░#░▓░░░▓░░▓░░░░▓▓#░░░░▓▓░▓░░░░░░▓░░░░░▓░░░▓░░░░▓░░░▓░▓░░▓░░░▓░░░░░░░░░░░░▓#░▓░░░░░
░░░░░░░▓░▓░░▓░▓▓░░▓░░░░░░░░░░▓░#░░░░░░▓░▓#░░▓░░░░░#▓░░░▓░░▓░░░#▓▓▓▓▓▓▓▓▓▓▓▓▓▓▓▓▓▓▓▓▓▓▓▓▓▓▓▓▓▓▓▓▓▓▓▓▓▓▓▓▓▓▓▓▓▓▓▓▓▓▓▓▓▓▓#░░▓░░▓░░░#░
░░░░░░░▓░▓░░▓░▓▓░░▓░░##░░░#░░▓░░░░░░░░▓░▓░░░▓░░░░░░▓░░░▓░░▓░░░░▓▓▓░░░░▓▓░▓░░░░░#▓░░░░░▓░░░▓░#░░▓░░░▓░▓░░▓░░░▓░░#░░#░░▓░░░▓░░▓##░░░
░░░░░░░▓░▓░░▓░▓▓#░▓░░░▓▓▓▓▓#░▓░#░░░░░░▓░▓░░░▓░░░░░░▓░░░▓░░▓░░░░▓▓▓░░░░▓▓░▓░░░░░░▓░░░░░▓░░░▓░#░░▓##░▓░▓░░▓░░░▓░░░░░▓▓▓▓▓▓▓▓▓▓▓▓▓▓▓▓
░░░░░░░▓░▓░░▓░▓▓░░▓#░░▓░░░▓░#▓░▓▓▓▓▓▓▓▓▓▓▓▓▓▓▓▓▓▓▓▓▓▓▓▓▓▓▓▓▓#░░▓▓▓░░░░▓▓░▓░░░░#░▓░░░░░▓░#░▓░░░░▓░░░▓░▓░░▓░░░▓░░░░░▓░░▓░░░▓░░▓░░░░░
░░░░░░░▓░▓░░▓░▓▓░░▓░░░▓░░░▓░░▓░▓░░░░░░▓░▓░░░▓░░░░░░▓░░░▓░░▓▓░░░▓▓▓░░░░▓▓░▓░░░░░░▓░░░░░▓░▓▓▓▓▓▓▓▓▓▓▓▓▓▓▓▓▓▓▓▓▓▓▓▓▓#▓▓▓▓▓▓▓▓░░▓░░░░░
░░░░░░░▓░▓░░▓░▓▓░░▓░░░▓░░░▓░#▓░▓░░░░░░▓░▓░░░▓░░░░░░▓░░░▓░░▓▓░░░▓▓▓░░░░▓▓░▓░░░░░░▓░░#░░▓░▓░▓░░░░▓░░░▓░▓░░▓░░░▓░░░▓░░░░▓░░░#░░▓░░░#░
░░░░░░#▓▓▓▓▓▓▓▓▓░░▓░░░▓#░░▓░░▓░▓░░░░░░▓░▓░░░▓░░░░░░▓#░░▓░░▓▓░░░▓▓▓░░░░▓▓░▓░░░░░░▓░░░░░▓░▓░▓░░░░▓░░░▓░▓░░▓░░░▓░░░▓░░░░▓░░░░░░▓░░░░░
░░#░░░░░░▓░░▓░#▓░░▓░#░▓░░░▓░░▓#▓░░░#░░▓░▓░░░▓░░░░░░▓#░░▓░░▓▓░░░▓▓▓░░░░▓▓░▓░░░░░░▓░░░░░▓░▓░▓░░░░▓░#░▓░▓░░▓░░░▓░░░▓░░░░▓░░░░░░▓░░░░░
░░▓▓▓▓▓▓▓▓▓▓▓▓▓▓▓▓▓▓▓▓▓▓▓▓▓▓▓▓▓▓▓▓#░░░▓░▓░#░▓░░░░░#▓░░░▓░░▓▓░░#▓▓▓░░░░▓▓#▓░░░░░░▓░░░░░▓░▓#▓▓▓▓▓▓▓▓▓▓▓▓▓▓▓▓▓▓▓▓▓▓▓▓▓▓▓▓▓▓▓▓▓▓▓░░#░#
░░▓░░░░░░▓░░▓░░▓░░▓░░░▓░░░▓░░▓░▓░▓░░░░▓░▓░░░▓░░#░░▓▓▓▓▓▓▓▓▓▓▓▓▓▓▓▓▓▓▓▓▓▓▓▓▓▓▓▓▓▓▓▓▓▓▓▓▓▓▓▓▓▓#░#▓░░░▓░▓░░▓░░░▓░░░▓░░░#▓░░░░░░##░░░░
░░▓░░░░░░▓░░▓░░▓░░▓░░░▓░░░▓░░▓#▓░▓░░░░▓░▓░░░▓░#▓▓▓▓▓▓▓▓▓▓▓▓▓▓▓▓▓▓▓▓▓▓▓▓▓▓▓▓▓▓#░░▓#░░░#▓▓▓▓▓▓▓▓▓▓▓▓▓▓▓▓▓▓▓▓▓▓▓▓▓▓▓░░#░▓░░░░░░░░░#░░
░░▓░░░░#░▓░░▓░░▓░░▓#░░▓░░░▓░░▓░▓░▓░░░░▓░▓░░░▓░░▓░░▓▓░░░▓░░▓▓░░░▓▓▓░░░░▓▓░▓░░▓░#░▓░░░░░░#▓░#▓░░░▓░░░▓#▓░░▓░#░▓░░░#░░░#▓░░░░░░░░░░░░
░░▓░░░░░░▓░░▓░░▓░░▓▓▓▓▓▓▓▓▓▓▓▓▓▓▓▓▓▓▓▓▓▓▓▓▓▓▓▓▓▓▓▓▓▓▓▓#▓#░▓▓░░░▓▓▓░░░#▓▓░▓░░▓░░#▓#░░░░░░▓░▓▓▓#░▓░░░▓░▓##▓░░░▓#░░░░░░░▓░░░░░░░░░░░░
░░▓░░░░░░▓░░▓░░▓░░▓▓░░▓░░░▓░░▓░▓░▓░░░░▓░▓░░░▓░░▓░░▓▓░▓░▓░░▓▓░░░▓▓▓░░░░▓▓░▓░#▓░░░▓░░░░░#░▓░▓▓▓░░▓░░░▓░▓▓▓▓▓▓▓▓▓▓▓#░░░░▓░░░░#░░░░░░░
░░▓░#░░░░▓░░▓░░▓░░▓▓░░▓░░░▓░░▓#▓▓▓▓▓▓▓▓▓▓▓▓▓▓▓▓▓▓▓▓▓▓▓▓▓▓▓▓▓▓▓▓▓▓▓▓▓▓▓▓▓▓▓▓▓▓▓▓▓▓▓▓▓▓▓▓▓▓▓▓▓▓▓▓▓▓▓▓▓▓▓▓▓▓░░░▓░░▓░░░░#▓░░#░░░░░░#░░
░░▓#░░░░░▓░#▓▓▓▓▓▓▓▓▓▓▓▓▓▓▓▓▓▓▓▓▓▓░░░░▓░▓░░░▓░░▓░░▓▓░▓░▓░░▓▓░░░▓▓▓░░░░▓▓#▓░░▓░░░▓░░░░░░░▓░▓▓▓░░▓░░░▓░▓▓░#░░░▓░░▓░░░░░▓░░░░░░░##░#░
░░▓▓▓▓▓▓▓▓▓▓▓▓▓▓▓▓▓▓▓▓▓▓▓▓▓▓▓▓▓▓▓#░░░░▓#▓▓▓▓▓▓▓▓▓▓▓▓▓▓▓▓▓▓▓▓▓▓▓▓▓▓▓▓▓▓▓▓▓▓▓▓▓▓▓▓▓▓▓▓▓▓▓▓▓▓▓▓▓▓▓▓▓▓▓▓░▓▓░#░░░▓░░▓░░░░░▓░░░░░░░░░░░░
░░▓▓░░░░░▓░░░░░▓░░▓▓░░▓░░░▓░░▓░░▓░░░░#▓░░░░░▓░░▓░░▓▓░▓░▓░░▓▓░░#▓▓▓░░░░▓▓░▓░░▓░░░▓░░░░░░░▓░▓▓▓░░▓░░░#░▓▓░░░░░▓░░▓░░░░░▓░░░░░░░░░░░░
░░▓▓░░░░░▓░░░░#▓▓▓▓▓▓▓▓▓▓▓▓▓▓▓▓▓▓░░░░░▓░░░░░▓░░▓░░▓▓░▓░▓░░▓▓░░░▓▓▓░░░░▓▓░▓░░▓░░░▓░░░░░#░▓░▓▓▓░#▓░░░░░▓▓░░░░░▓░░▓░░░#░▓░░░░░░░░#░░░
░░▓▓░░░░░▓░░░░░░░░▓▓░░▓░░░▓░░▓░░#░░░░░▓░░░░░▓░░▓░░▓▓░▓░▓░░▓▓░░░▓▓▓░░░░▓▓░▓░#▓░░░▓░░░░░░░▓░▓▓▓░░▓░░░░░▓▓░░░░░▓#░▓░░░#░▓░░░░░░░░░░░░
░░▓▓░░░░░▓░#░░░░░░▓▓░░▓░░░▓░░▓░░▓▓▓▓▓▓▓▓▓▓▓▓▓▓▓▓▓▓▓▓▓▓▓▓▓▓▓▓▓▓▓▓▓▓▓#░░▓▓░▓░░▓░░░▓░░#░░░░▓░▓▓▓░░▓░░░░░▓▓░░#░░▓░░▓░░░░░▓░░#░░░░░░#░░
░░▓▓░░░░░▓░░░░░░░░▓▓░░▓░░░▓░░▓░░▓░#░░░▓░░░░░▓░░▓░░▓▓░▓░▓░░▓▓░#░▓▓▓▓░░░▓▓░▓░░▓░░░▓░░░░░░░▓░▓▓▓░░▓░░░░░▓▓░░░░░▓░░▓░░░░░▓░░░░░░░░░#░░
░░▓▓░░░░░▓░░░##░░░▓▓░#▓▓▓▓▓▓▓▓▓▓▓▓▓▓▓▓▓▓▓▓▓▓▓▓▓▓▓▓▓▓▓▓▓▓▓▓▓▓░░░▓▓▓▓░░░▓▓░▓#░▓░░░▓#░░░░░░▓░▓▓▓░░▓░░░░░▓▓░░░░░▓░░▓░░░░░▓░░░░░░░░░░░#
#░▓▓░░░░#▓▓▓▓▓▓▓▓▓▓▓░░░░░░▓░#▓░░▓░░░░░▓#░░░░▓░░▓░░▓▓░▓░▓░░▓#░░░▓▓▓▓░░░▓▓░▓░░▓#░░▓░░░░░░░▓░▓▓▓░░▓░░░░░▓▓░░░░░▓░░▓░░░░░▓░░░░░░░░░░#░
░░▓▓░░░#░░░░░░░░░░#▓░░░░##▓░░▓░░▓░░░░#▓░░░░░▓░░▓░░▓▓░▓░▓░░▓░░#░▓▓▓▓░░░▓▓░▓#░▓▓▓▓▓▓▓▓▓▓▓▓▓▓▓▓▓▓▓▓▓▓▓▓▓▓▓▓▓#░░▓░░▓░░░░░▓░#░░░░░░░░░░
░░▓▓░░░░░░░░░#░░░░░▓░░░░░░▓░░▓░░▓##░░░▓░░░░░▓░░▓░░▓▓░▓░▓░░▓░░▓▓▓▓▓▓▓▓▓▓▓▓▓▓▓▓▓▓▓▓▓▓▓▓▓▓▓▓▓▓▓▓▓▓▓▓▓▓▓▓▓▓▓▓▓▓▓▓▓▓▓▓▓▓▓▓▓▓▓▓#░░░░░░░░
#░▓▓░░░░░░░░░░░░░░░▓░░░░░░▓░░▓#░▓░▓▓▓▓▓▓▓▓▓▓▓▓▓▓▓▓▓▓▓▓▓▓▓▓▓▓▓▓▓▓▓▓▓▓▓▓▓▓▓▓▓▓▓▓▓▓▓▓▓▓▓▓▓▓▓▓▓▓▓▓▓▓▓▓#░░▓▓░▓░░░▓░░▓░░░░░▓░░▓░░░░░░░░░
░#▓▓░░░░░░░░░░░░░░░▓░░░░░░▓░░▓░░▓░▓░░#▓░░░##▓▓▓▓▓▓▓▓▓▓▓▓▓▓▓▓▓▓▓▓▓▓▓▓▓▓▓▓▓▓▓▓▓▓▓▓▓▓▓▓▓▓▓▓▓▓▓▓▓▓▓▓░▓░░░▓▓░▓░░░▓░░▓░░░░░▓░░▓░░░░░#░░░
░░▓▓░░░░░░░░░░░░░░░▓░░░░░░▓░░▓░░▓#▓#░░▓░░░░░░░░▓░░▓▓░▓#▓░#▓░#▓░▓▓▓▓░░░▓▓░▓░░▓▓░░▓░░░░░░#▓░▓▓▓░░#░▓░░░▓▓░▓░░░▓░░▓░░░░░▓░░▓░░░░░░░░░
░░▓▓░░░░░░░░░░░░░░#▓░░░#░░▓░#▓▓▓▓▓▓▓▓▓▓▓▓▓▓▓▓▓▓▓▓▓▓▓▓▓▓▓▓▓▓▓▓▓▓▓▓▓▓░░░▓▓░▓░░▓▓░░▓#░░░░░░▓░▓▓▓░░░░▓░░░▓▓░▓░░░▓░░▓░░░░░▓#░▓░░░░░░#░░
░░▓▓░░░░░░░░░░░░░░░▓░░░░░░▓░░░░░▓░▓░░░▓░░░#░░░#▓░░▓▓#▓░▓░░▓░░▓░▓#▓▓░░░▓▓░▓#░▓▓░░▓░░░░░░#▓░▓▓▓░░░░▓░░#▓▓░▓░░░▓░░▓░░░░░▓░░▓░░░░░░#░░
░░▓▓░░░░░░░░░░░░░░░▓░░░░░░▓░░░░░▓░▓░░░▓░░░░░░░░▓░░▓▓░▓░▓░░▓░░▓░▓░▓▓░░░▓▓░▓▓▓▓▓▓#▓▓▓▓▓▓▓▓▓▓▓▓▓▓▓▓▓▓▓▓▓▓▓▓▓▓▓▓▓▓▓▓▓▓▓▓▓▓░░▓░░░░░#░░░
░░▓▓░░░░░░░░░░░░░░░▓░░░░░░▓░░#░░▓░▓░#░▓░░░░░░░░▓░░▓▓░▓░▓░#▓░░▓#▓▓▓▓▓▓▓▓▓▓▓▓▓▓▓▓▓▓▓▓▓▓▓▓▓▓▓▓▓▓▓▓▓▓▓▓▓▓▓▓▓▓░░░▓░░▓░░░#░#░#▓░░░░░░░░░
░░▓▓░░░░░░░░░░░░##░▓░░░░#░▓░░░░░▓#▓░░░▓░░░#░░░░▓░░▓▓░▓#▓░░▓░░▓░░░▓▓░░░▓▓░▓▓░▓▓▓░░#░░░░░░▓░▓▓▓░░░░▓░░░▓▓░#░░░▓░░▓░░░░░░░#▓░░░░░░░░░
░░▓▓░░░░░░░░░░░░░░░▓░#░░░░▓#░░#░▓░▓░░░▓░░░▓▓▓▓▓▓▓▓▓▓▓▓▓▓▓▓▓▓▓▓▓▓▓▓▓▓▓▓▓▓▓▓▓▓▓▓▓▓▓▓▓▓▓▓▓▓▓▓▓▓▓▓▓▓▓▓▓▓▓▓▓▓▓▓▓▓▓▓▓▓▓▓▓▓▓▓▓▓▓▓▓▓#░░░░░
░░▓▓░░░#░░#░░░░░░░░▓░░#░░░▓░░░░░▓░▓░░░▓░░░▓░░░░▓░░▓▓░▓░▓░░▓░░▓░░░▓▓░░░▓▓░▓▓░▓▓▓░░░░░░░░#▓▓▓▓▓▓▓▓▓▓▓▓▓▓▓▓▓▓▓▓▓░░▓░░░░░░░░▓░░▓░░░░░░
#░▓▓░░░░░░░░░░░░░░░▓░░▓▓▓▓▓▓▓▓▓▓▓▓▓▓▓▓▓▓▓▓▓▓▓▓▓▓▓▓▓▓▓▓▓▓▓▓▓▓▓▓▓▓▓▓▓▓▓▓▓▓▓▓▓▓▓▓▓▓▓▓▓▓▓▓▓▓▓▓▓▓▓▓▓▓▓▓▓▓▓▓▓▓#░░░#░░▓░░░░░░░░▓░░▓░░░░░░
░#▓▓▓▓▓▓▓▓▓▓▓▓▓▓▓▓▓▓▓▓▓▓▓▓▓░░░░░▓░▓░░░▓░░░▓░░░░▓░░▓▓░▓░▓░░▓░#▓░░░▓▓░░░▓▓░▓▓░▓▓▓░░░░░░░░░░░▓▓▓░░░░▓░░░▓▓▓░░░░░░░▓░░#░░░░░▓░░▓░░░░░░
#░░▓░░#░░░#░░░░░░░░▓░░▓░░░#░░#░░▓░▓░#░▓░░░▓░░#░▓#░▓▓░▓░▓░░▓░░▓░░░▓▓░#░▓▓░▓▓░▓▓▓░░░░░░░░░#░▓▓▓░░░░▓░░░▓▓▓░░#░░░░▓░░░░░░░░▓░░▓░░░░░░
░░#▓░░░░░░▓▓▓▓▓▓▓▓▓▓▓▓▓▓▓▓▓▓▓▓▓▓▓▓▓▓▓▓▓▓▓▓▓▓▓▓▓▓▓▓▓▓▓▓▓▓▓▓▓▓▓▓▓▓▓▓▓▓▓▓▓▓▓▓▓▓▓▓▓▓▓▓▓▓#░#░░░▓▓▓░░░░▓░░░▓▓▓░░░░░#░▓░░░░░░░░▓░░▓░░░░░░
░░░▓░░░░░░▓░░░░░░░░▓░░▓#░░░░░░░░▓░▓░░#▓░░░▓░░░░▓#░▓▓░▓░▓░░▓░░▓░░░▓▓░░░▓▓#▓▓░▓▓▓░░░░▓░░░░░░▓▓▓░░░░▓░░░▓▓▓░░░░#░░▓░░░░░░░░▓░░▓░░░░░░
░░░▓░░░░░░▓░░░░░░#░▓░░▓░#░░░░░░#▓░▓#░#▓#░░▓░░░░▓░░▓▓░▓░▓░░▓░░▓░░░▓▓░░#▓▓░▓▓░▓▓▓░░░░▓░░░░░░▓▓▓░░░░▓░░░▓▓▓░░░░▓▓▓▓▓▓▓▓▓▓▓▓▓▓▓▓▓#░░░░
░░#▓▓▓▓▓▓▓▓▓▓▓▓▓▓▓▓▓▓▓▓▓▓▓▓▓▓▓▓▓▓▓▓▓▓▓▓▓▓▓▓▓▓▓▓▓▓▓▓▓▓▓▓▓▓▓▓░░▓░░░▓▓░░░▓▓░▓▓░▓▓▓░░░░▓░░░░░░▓▓▓░░░░▓░░░▓▓▓░░░░▓░#▓░░░░░░░░▓░░▓▓░░░░░
░░░░░░░░░░▓░░░░░░░░▓░░▓░░░░░░░░░▓#▓░░░▓░░░▓░░░░▓░░▓▓#▓░▓░░#░░▓░░░▓▓#░░▓▓░▓▓░▓▓▓░░░░▓░░░░░░▓▓▓░░░░▓░░░▓▓▓░░░░▓░░▓░░░░░░░░▓░░▓▓#░░░░
░░░░░░░░░░▓░░#░░░░░▓░░▓░░░░░░░░░▓░▓░#░▓░░░▓░░░░▓░░▓▓░▓░▓░░░░░▓░░░▓▓░░░▓▓░▓▓░▓▓▓░░░░▓#░░░#░▓▓▓░░░░▓░░░▓▓▓░░░░▓░░▓░░░░░░#░▓░#▓▓░░#░░
░#░░░░░░░░▓░░░░░░░░▓░░▓░░░░░░░#░▓░▓░░░▓░░░▓░░░░▓░░▓▓░▓░▓░#░#░▓░░░▓▓░░░▓▓░▓▓░▓▓▓░░░░▓░░░#░░▓▓▓░░░░▓░░░▓▓▓░░░░▓░░▓░░#░#░░░▓░░▓▓░░░░░
░░░░░░░░░░▓░░░░░░░░▓░░▓░░░░░░#░░▓░▓░░░▓#░░▓░░░░▓░░▓▓░▓░▓░##░░▓░░░▓▓░░░▓▓░▓▓░▓▓▓░░░░▓░░░#░░▓▓▓░░░░▓░░░▓▓▓░░░#▓░░▓░░░░░░░░▓░░▓▓░░░░░
░░░░░░░░░#▓░░░░░#░░▓░#▓░░░░░░░░#▓▓▓▓▓▓▓▓▓▓▓▓▓▓▓▓▓▓▓▓▓▓▓▓▓▓▓▓▓▓▓▓▓▓▓▓▓▓▓▓▓▓▓▓▓▓▓░░░░▓░░░░░░▓▓▓░░░░▓░░░▓▓▓░░░░▓░░▓░░░░░░░░▓░░▓▓░#░░#
░░░░░░░░░░▓░░░░░░░░▓░#▓░░░░░#░░░░░▓░░░▓░░░▓░░░#▓░#▓▓░▓░▓░░░░░▓░░░▓▓░░░▓▓░▓▓░#▓▓▓▓▓▓▓▓▓▓▓▓▓▓▓▓░░#░▓░░░▓▓▓░░░░▓░░▓░░░░░░░░▓░░▓▓░#░#░
░░░░░░░░░░▓░░░░░░░░▓░░▓░░░░░░░░░░░▓░░░▓░░░▓░░░░▓░░▓▓░▓░▓#░░░░▓░░░▓▓░░░▓▓░▓▓░░░▓#░░░▓░░░░░░▓▓#░░░░▓░░#▓▓▓░░░#▓▓▓▓▓▓▓▓▓▓▓▓▓░░▓▓░░░░░
░░░░░░░░░░▓░░░░░░░░▓░░▓░░░░░░░░░░░▓░░░▓░#░▓░░##▓#░▓▓░▓░▓░#░░░▓░░#▓▓░░░▓▓░▓▓░░░▓░░░░▓░░░░░░▓▓░░░#░▓░░░▓▓▓░░#░░░░▓░░░░░#░##░░▓▓░░░░░
░░░░░░░░░░▓░░#░░░░░▓░#▓░░░░░░#░░░░▓░░░▓░░░▓░░░░▓░░▓▓#▓░▓░░░░░▓░░░▓▓░░░▓▓░▓▓░░░▓░░░░▓░░░░░░▓▓░░░#░▓░░░▓▓▓░#░░░░░▓░░░░░░#░░░#▓▓░#░#░
░░░░░░░░░░▓░░░░░░░#▓▓▓▓▓▓▓▓▓▓▓▓▓▓▓▓▓▓▓▓▓▓▓▓▓▓▓▓▓▓▓▓▓▓▓▓▓▓▓▓▓▓▓▓▓▓▓▓░░░▓▓░▓▓#░░▓░░░░▓░░░░░░▓▓░░░░░▓░░░▓▓▓░░░#░░░▓░#░░░░░#░░░▓▓░░░░░
░░░░░░░░░#▓░░░░░░░░░░░▓░░░░#░░░░░░▓░#░▓░░░▓░░░░▓░░▓▓░▓░▓░░░░░▓░░░▓#░░░▓▓░▓▓░░░▓░░░░▓##░░░░▓▓#░░░░▓░░░▓▓▓░░░░░░░▓░░░░░░░░░░░▓▓░░░#░
░░░░#░░░░░▓░░░░░░░░░░░▓░#░#▓▓▓▓▓▓▓▓▓▓▓▓▓▓▓▓▓▓▓▓▓▓▓▓▓▓▓▓▓▓▓▓▓#▓░░#▓▓▓▓▓▓▓▓▓▓▓▓▓▓▓▓▓▓▓▓▓▓▓▓▓▓▓▓▓▓▓▓▓▓▓▓▓▓▓░░░░░░░▓░░#░░░░░░░░▓▓░░░░░
░░░░░░░░░░▓░░░░░░#░░░░▓░░░░▓░░░░░░▓░░░▓░░░▓░░░░▓░░▓░░▓░▓░░░▓░▓░#░░░░░░▓▓░▓▓░░░▓░#░░▓░░#░░░▓▓░#░░░▓░░░#▓▓░░░░░░░▓░░░░░░░░░#░▓▓░░░░░
░░░░░░░░░░▓░░░░#░▓▓▓▓▓▓▓▓▓▓▓▓▓▓▓▓▓▓▓▓▓▓▓▓▓▓▓▓▓▓▓▓▓▓▓▓▓▓▓▓▓▓▓▓▓▓▓▓▓▓▓▓▓▓▓▓▓▓▓▓▓▓▓▓▓▓▓▓▓▓▓▓▓▓▓▓▓▓#░▓#░░░▓▓░░░░░░░▓░░#░░░░░░░░▓▓░░░░░
░░░░░░░░░░▓░░░░░░▓░░░░▓░░░░▓░░░░░░▓░░░▓░##▓▓▓▓▓▓▓▓▓▓▓▓▓▓▓▓▓▓▓▓▓▓▓▓▓▓▓▓▓▓▓▓▓░░░▓░░░░▓░░░░░░▓▓░░▓░░▓░░░░▓▓░░░░░░░▓░░░░##░░░░░▓▓░░░░░
░░░░░░░░░░▓░░░░░░▓░░░░▓░░░░▓░░░░░░▓░░░▓░░░░░#░░▓░░▓░░▓░▓░░░▓░▓░░#░░░░░▓▓░#▓░░#▓░░#░▓░░#░░░▓▓░░▓░#▓░░░░▓▓░░░░░░░▓░░░░#░░░░░░▓▓░░░░░
░░░░░#░░░#▓░░░░░░▓░░░░▓░░░░▓░#░░░░▓░░░▓░░░░░░░░▓░░▓░░▓░▓░░░▓░▓░░░░#░░░▓▓░#▓░░░▓░░░░▓░#░░░░▓▓░░▓░░▓░░░#▓▓▓▓▓▓▓▓▓▓▓▓▓▓▓▓▓▓▓▓▓▓▓░░░░░
░░░░░░░░░░▓░░░░░░▓░░░░▓░#░░▓░░░░░░▓░░░▓░░░░#░░░▓░░▓░░▓░▓░░░▓░▓░░░#░░░░▓▓░▓▓▓▓▓▓▓▓▓▓▓▓▓▓▓▓▓▓▓▓▓▓▓▓▓▓▓▓▓▓▓▓▓▓▓▓▓▓▓▓▓▓#░░░░░░##▓░░░░░
░░░#░░░░░░▓░░░░░░▓░░░#▓░░░░▓░░░░░░▓░░░▓░░░#░░░░▓░░▓░░▓░▓░░░▓░▓░░░░░░░░▓▓░▓▓░░#▓#░░░▓░░░░░░▓▓░░▓░░▓░░░░░▓░#░░░░░▓░#▓░░░░░░░░░▓░░░░░
░░░░░░░░░░▓░░░░░░▓░░#░▓░░░░▓░░░░░#▓▓▓▓▓▓▓▓▓▓▓▓▓▓▓▓▓▓▓▓░▓░░░▓░▓░░░░░░#░▓▓#▓▓░░░▓#░░░▓░░░░░░▓▓░░▓░░▓░░#░░▓░░░░░░░▓░░▓░#░░░░░░░▓░░░░░
░░░░░#░░░░▓░░░░░░▓░░░#▓░░░░▓░###░░░░░░▓░#░░░░░░▓░░▓░░#░▓░░░▓░▓░░░░░░░░▓▓░▓▓░#░▓░░░░▓#░░░░#▓▓░░▓░░▓░░░░░▓░░░░░░░▓░░▓░░░░░░░░░▓░░░░░
░░░░░░░░░░▓░░░░░░▓░░#░▓░░░░▓░#░░░░░░░░▓░░#░░░░░▓░░▓░░░░▓░░░▓░▓░░░░░░░░▓▓░▓▓░#░▓#░░░▓░░░░░░▓▓░░▓░#▓░░░░░▓░░░░░░#▓░░▓░░░░░░░░░▓░░░░░
░░░░░#░░░░▓░░░░░░▓░░░░▓░#░░▓░░░░░░░░░░▓░░░░░#░#▓░░▓░░░░▓░░░▓░▓░░░░░░░░▓▓░▓▓░░░▓░░#░▓░░░░░#▓▓#░▓░░▓░░░░░▓░░░░░░░▓░░▓░░░░░░░░░▓░░░░░
░░#░░#░░░░▓░░#░░░▓░░░░▓░░░░▓░░░░░░░░░░▓░░░░░░░░▓░░▓░░░#▓▓▓▓▓▓▓▓▓▓▓▓▓▓▓▓▓▓▓▓▓▓▓▓▓▓▓▓▓▓▓▓▓▓▓▓▓░░▓░░▓░░░░░▓░░░░░░░▓░░▓░░░░░#░░░▓░░░░░
░░░░░░░#░░▓░░░░░░▓░░#░▓░#░░▓░#░░░░░░░░▓░░░░░░░░▓░░▓░░#░#░░░▓░▓░░░░░░░░▓▓░▓▓░░░▓░░░░▓░░░░░░▓#░░▓░░▓░░░░░▓░░░░░░░▓░░▓░░#░░#░#░▓░░░░░
░░░░░░░░░░▓░░░#░░▓░░░░▓░░░░▓░░░░░░░░░░▓░░░░░░░░▓░░▓░░▓▓▓▓▓▓▓▓▓▓▓▓▓▓▓▓▓▓▓▓▓▓▓▓▓▓▓▓▓▓▓▓▓▓▓▓▓▓▓▓▓▓▓▓▓▓▓▓▓▓▓▓▓▓▓▓▓▓▓▓▓▓▓▓#░░░░░░▓░░░░░
░░░░░░░░░░▓░#░░░░▓░░░░▓░░░░▓░░░░░#░░░░▓░░░░░░░░▓░░▓░░▓░░░░#▓░▓░░░░░░#░▓▓#▓▓▓▓▓▓▓▓▓▓▓▓▓▓▓▓▓▓▓▓▓▓▓▓▓▓▓▓▓▓▓▓▓▓▓▓▓▓▓▓▓▓▓▓▓▓▓▓▓▓▓▓░░░░░
░░░░░░░░░░▓░░░░░░▓░░░░▓░░░░▓░░░░░░░#░░▓░░░░░░░░▓░░▓░░▓░░░░░▓░▓░░░░#░░░▓▓░░▓░░░▓░░░░▓░░░░░░▓░░░▓░░▓░░░░░▓░░░░░░░▓░░▓░▓░░░░░░░#░░░░░
░░░░░░##░░▓░░░░░░▓░#░#▓░░░░▓░░░░░░░░░░▓░░░░░░░#▓▓▓▓▓▓▓▓▓▓▓▓▓▓▓▓▓▓▓▓▓▓▓▓▓▓▓▓▓▓▓▓▓▓▓▓▓▓▓▓▓▓▓▓▓▓▓▓▓▓▓▓▓▓▓▓▓▓▓▓▓▓▓▓▓░░▓░▓░░░#░░░░░░░░░
░░░░░░░░░░▓░░░░░░▓░░░░▓░░░#▓▓▓▓▓▓▓▓▓▓▓▓▓▓▓▓▓▓▓▓▓▓▓▓▓▓▓▓▓▓▓▓▓▓▓▓▓▓▓▓▓▓▓▓▓░░▓░░░▓░#░░▓░░░░░░▓░░░▓░░▓░░░░░▓░░░░░░░#░░▓░▓░░░░░░░░░#░░░
░░░░░░░░░░▓░░░░░░▓░░░░▓░░#░░░#░░░░░░░░▓░░░░░░░░░░░▓#░▓#░░░░▓░▓░░░░░░░░▓#░░▓░░░▓░░░░▓░░░░░░▓░░░▓░░▓░░░░░▓░░░░░░░░░░▓░▓░░░#░░░░#░░░░
░░░#░░░░░░▓░░░░░░▓░░░░▓░░░░░░░░░░░░░░#▓░░#░░░░░░░#▓▓▓▓▓▓▓▓▓▓▓▓▓▓▓▓▓▓▓▓▓▓▓▓▓▓▓▓▓▓▓▓▓▓▓▓▓▓▓▓▓▓▓▓▓▓▓▓▓▓▓▓▓▓░░░░░░░░░#▓░▓░░░░░░░░░░░░░
░░░░░░░░░░▓░░░░░░▓░░░░▓░░░░░░░░░░░#░░░▓░░░░░░░░░░░░░░▓░░░░░▓░▓░░░░░░░░▓#░░▓░░░▓░░░░▓░░░░░░▓░░░▓░░▓░##░░#░#░░░░░░░░▓░▓░░░░░░░░░░#░░
░#░░░░░░░░▓░░░░#░▓░░░#▓▓▓▓▓▓▓▓▓▓▓▓▓▓▓▓▓▓▓▓▓▓▓▓▓▓▓▓▓▓▓▓▓▓▓▓▓▓▓▓▓▓▓▓▓▓▓▓▓▓▓▓▓▓▓▓▓░░░░▓░#░░░░▓░░░▓░░▓░░░#░░░░░░░░░░░░▓░▓#░░#░░░░░░░░░
░░░░░░░░░#▓▓▓▓▓▓▓▓▓▓▓▓▓▓▓▓▓▓▓▓▓▓▓▓▓▓▓▓▓#░░░░░░░░░░░░░▓░░░░░▓░▓░░#░░░░░▓░░░▓░░░#░░░░▓░░░░░░▓░░░▓░░▓░░░#░░░░░░░░#░░░▓░▓░░░░░░#░░░░░░
░░░░░░░░░░░░░░░░░▓░░░░░░░░░░░░░░░░░#░░#░░░#░░░░░░░░░░▓░░░░░▓░▓░░░░░░░░▓░░░▓░░░░░#░░▓░░░░░░▓░░░▓░░▓░░░░░░░░░░░░░░░░▓░▓░░░░░░░░░░░░░
░░░░░░░░░░░░░░░░░▓░░░░░░░░░░░░░░░░░░░░░░##░░░░░░░░░░#▓▓▓▓▓▓▓▓▓▓▓▓▓▓▓▓▓▓▓▓▓▓▓▓▓▓▓▓▓▓▓▓▓▓▓▓▓▓▓▓▓▓▓▓▓░#░░░░░░░░░░░░░░▓░▓░░░░#░░░░░░░░
░░░░░░#░░░░░░░░░░▓░░░░░░░░░░░░░░░░░░░░░░░░░░░░░░░░#░░░░#░░░▓░▓░░░░░░░░▓░░░▓░░#░░░░░▓░░░░░░▓░░░▓░░#░░#░░░░░░░░░#░░░▓░▓░░░░░░░░░░░░░
░#░░░░#░░░░░#░░░░▓░░░##░░░░░░░░░░░░░░░░░░░░░░░░░░░░░░░░░░#░▓░▓░░#░░░░░▓░░░▓░░░░░░░░▓░░░░░░▓░░░▓░░░░░░░░░░░░░░░░░░#▓░▓░#░░##░░░░░░░
░░░░░░░░░░#░░░░░░▓░░░░░░░░░░░░░░░░░░░░░░░░░░░░░░░░░░░░░░░░░▓░▓░░░░░░░░▓░░░▓░░░░##░░▓░░░░░░▓░░░▓░░░░░░░░░░░#░░░░░░░▓░▓░#░░░░░░░░░░░
░░░░░░░░░░░#░#░░░▓░░#░░░░░░░#░░░░░░░░░░░░░░░░░░#░░░░░░░░░░░▓#▓▓▓▓▓▓▓▓▓▓▓▓▓▓▓▓▓▓▓▓▓▓▓░░░░░░▓░░░▓░░░░░░░░░░░░░#░░░#░▓░▓░░░░░░░░░░#░░
░░░░░░░░░░░░░░░░░▓░░░░░░░░░░░░░░░░░░░░░░░░░░░░░░░░░░░░░░░░░▓░░░░░#░░░░▓░░#▓░░░░░░░░#░░░░░#▓▓▓▓▓░░░#░░░░##░░░░#░░░░▓░▓░░░#░░░░░░░░░
░░░░░░░░░░░░░░░░░▓░░░░░░░░░░░#░░░░░░░░░░░░░░░░░░░░░░░░░░░░░▓░░░░░░░░░░▓░░░▓░░░░░░░░░#░░░░░#░░░#░░░#░░░░#░░░░░░░░░░▓#▓░░░░░░░░░#░#░
░░░░░░░░░░░░░░░░░▓░░░#░░░░░░░░#░░░░░░░░░░░░░░░░░░░░░░░░░#░░▓░░░░░░░░░░▓░░░▓░░░░░░░░░░░░░░░░░░░░#░░░░░░░░░░░░░░░░#░▓░▓░░░░░░░░░░░#░
░░░░░░░░░░░░░░░░░▓░░░░░░░░░░░░░░░░░░░░░░░░░░░░░░░░░░░░░░░░░▓░░░░░░░░░░▓░░#▓▓▓▓▓▓▓▓▓▓▓▓▓▓▓▓▓▓▓▓▓▓▓▓▓▓▓▓▓▓▓▓▓▓▓▓▓▓▓▓▓▓▓░░░░░░░░#░░░░
░░░░░░░░░░░░░░#░░▓#░░#░░░░░░░░░░░░░░░░#░░░░░░░░░░░░░░░░░░░░▓░░░░░░░░░░▓░░░░#░░░░░░░#░░░░#░#░░░░░░░░░░░░░░░#░░░░░░░▓░#░░░░░░░░░░░░░
░░░░░░░#░░░░░░#░#▓▓▓▓▓▓▓▓▓▓▓▓▓▓▓▓▓▓▓▓▓▓▓▓▓▓▓▓▓▓▓▓▓▓▓▓▓▓▓▓▓▓▓░#░░░░░░░#▓▓▓▓▓▓▓▓▓▓▓▓▓▓▓▓▓▓▓▓▓▓▓▓▓▓▓▓▓▓▓▓▓▓▓▓▓▓▓▓▓▓▓▓▓░░░░░░░░░░░░░░░
##░░░░░░░░░░░░░░░░░░░░░░░░░░░░░░░░░░░░░░░░░░░░░░░░░░░░░░#░░#░░░░░░░░░░░░░░░░░░░░░░░░░░░░░░░░░##░░░░░░░░░░░░░░░░░░░#░░#░░░░░░░░░░░#
░░░░░░░░░░░#░#░░░#░░░░░░░░#░░░░░░░░░░░░#░░░░░░░░░░░░░░░░░░░░░░░░░░░░░░#░░░░░░░░░░░░░░░░░░░░░░░░#░░░░░░░░░░░░░░░░░░░░░░░░░#░░#░░░░░
░░░░░░░░░░░░░░░░░░░░░░░░░░░░░░░░░░░░░░░░░░░░░░░░##░░░░░░░░░░░░░░░░░░░░░░░░░░░░░░░░░░░░░░░░░#░░░░░░░░░░░░░░░░░#░░░░░░░░░░░░░░░░░░░░
░░░░░░░░░░░░░░░░░░░░░░░░░░░░#░░░░░░░░░░░░░░░░░░░░░░░░░░░░░░░░░░░░░░░░░░░░░░░░░░░░#░░░#░░░░░░░░░░░░░░░░░░░░░░░░#░#░░░░░░#░░░░░░░░#░